57,6
000000000000000000000000000000000000000000000000001000000
000000000000000000000000000000000000000000000000011000000
000000000000000000000000000000000000000000000000111000000
000000011110000100000111000000110000000000000001111000000
000000000000000100000000000000110000000000000011111000000
111111111111111111110000011111111111000001111111111111111