57,6
000000000000000000000000000000000000000000000000003000000
000000000000000000000000000000000000000000000000031000000
000000000000000000000000000000000000000000000000311000000
000000022220000100000222000000220000000000000003111000000
000000000000000100000000000000110000000000000031111000000
111111111111111111110000011111111111000001111111111111111